XXXXXXXXX XXXXXX
X XXXXXXXXX X XXXX
X XXXXXXX XXX XXXX
XXX XXXXXX XXX XXXX
XXX XX XXXX
XXX XX X XXXXX XXX
XXXXXX X XXXXXX X
XXXXXX XXXXXX XXXD